00013118_008.png,61,973,50,910,164,250,200,329,0
00014716_007.png,54,962,0,962,632,817,817,1130,0
00029817_009.png,46,962,28,955,175,330,302,546,0
00014687_001.png,47,964,61,824,679,820,759,875,0
00017877_001.png,73,942,29,843,587,787,758,865,0
00003148_004.png,51,937,0,915,545,601,601,781,0
00012515_002.png,84,921,19,842,205,288,269,344,0
00022098_006.png,8,856,55,852,486,757,702,911,0
00014198_000.png,97,959,15,864,579,677,662,870,0
00021007_000.png,24,976,0,850,320,425,425,526,0
00030674_000.png,93,942,65,956,539,766,701,976,0
00003945_004.png,5,938,35,893,63,368,333,536,0
00000865_006.png,1,988,43,900,838,916,873,956,0
00007557_026.png,43,943,3,1020,88,309,306,432,0
00000181_061.png,55,928,41,915,154,367,326,621,0
00009669_003.png,67,940,0,996,90,351,351,571,0
00025368_014.png,48,970,51,951,246,363,312,447,0
00000468_033.png,120,977,57,930,84,200,143,253,0
00010770_000.png,68,932,0,745,176,382,382,450,0
00016972_019.png,43,940,132,991,471,769,637,997,0
00030635_001.png,56,930,58,926,520,760,702,982,0
00019124_045.png,108,919,36,876,224,349,313,417,0
00022883_002.png,15,915,0,892,99,832,832,940,0
00027094_003.png,119,944,56,828,650,802,746,953,0
00012123_001.png,31,958,58,902,608,881,823,1096,0
00020113_017.png,100,947,30,743,117,797,767,964,0
00004968_003.png,55,941,70,905,585,851,781,957,0
00028012_001.png,0,927,66,764,560,886,820,1084,0
00001170_046.png,6,930,30,827,629,874,844,1068,0
00016267_000.png,113,986,76,901,65,297,221,513,0
00018412_001.png,27,955,84,898,186,758,674,849,0
00007124_008.png,0,910,62,743,544,852,790,1038,0
00027866_002.png,51,951,41,1009,93,695,654,909,0
00000149_006.png,70,917,0,870,533,782,782,872,0
00030434_000.png,34,928,50,935,633,708,658,947,0
00019271_030.png,62,950,116,988,172,327,211,439,0
00020408_037.png,83,927,87,975,107,334,247,494,0
00023176_010.png,65,949,37,774,215,890,853,1047,0
00016191_017.png,86,918,35,939,597,796,761,959,0
00010478_012.png,84,963,53,874,128,375,322,576,0
00025228_005.png,97,917,69,781,494,789,720,1030,0
00021796_000.png,127,907,51,874,60,236,185,416,0
00008005_004.png,106,924,35,906,530,617,582,791,0
00021495_005.png,25,951,46,980,516,815,769,1080,0
00018496_006.png,24,972,83,1023,56,928,845,1147,0
00014607_007.png,95,962,110,971,106,748,638,961,0
00004968_004.png,25,941,0,945,609,873,873,997,0
00019271_064.png,64,946,62,863,201,794,732,1061,0
00010936_011.png,72,975,37,982,198,303,266,501,0
00000211_010.png,139,916,36,870,214,315,279,483,0
00017255_001.png,17,970,89,795,675,796,707,884,0
00007676_002.png,124,996,78,1018,236,318,240,454,0
00005089_002.png,54,936,19,881,594,857,838,1045,0
00020857_008.png,68,913,76,942,122,684,608,886,0
00012291_008.png,151,927,81,809,81,307,226,381,0
00018762_002.png,68,916,44,806,535,792,748,873,0
00000468_017.png,43,832,58,922,106,218,160,263,0
00014253_042.png,20,948,9,941,193,804,795,1116,0
00026136_002.png,48,918,74,776,502,780,706,888,0
00013685_000.png,136,890,40,695,122,233,193,282,0
00003787_003.png,173,968,81,775,116,284,203,403,0
00030106_008.png,140,1024,31,909,85,314,283,583,0
00030260_005.png,31,900,57,964,249,355,298,459,0
00015262_005.png,21,971,82,951,116,265,183,361,0
00006851_034.png,30,939,0,927,221,380,380,502,0
00019495_004.png,47,937,80,779,691,840,760,879,0
00017151_003.png,51,982,78,758,573,786,708,984,0
00006851_033.png,58,941,63,910,131,330,267,383,0
00000744_006.png,37,917,31,885,109,251,220,370,0
00013685_028.png,86,940,51,846,178,698,647,843,0
00010481_021.png,0,998,63,780,763,923,860,991,0
00026886_004.png,153,979,63,875,81,295,232,430,0
00016403_003.png,47,991,126,988,845,955,829,1021,0
00010575_002.png,25,964,0,879,207,441,441,599,0
00010575_002.png,25,964,0,879,670,918,918,1092,2
00011857_001.png,75,951,65,756,640,849,784,931,0
00011857_001.png,75,951,65,756,620,887,822,1052,2
00022155_008.png,42,912,23,827,643,799,776,875,0
00014870_004.png,33,960,63,897,82,304,241,398,0
00025221_001.png,0,920,59,1024,538,881,822,1201,0
00018253_017.png,131,905,75,827,417,580,505,785,0
00018253_017.png,131,905,75,827,4,151,76,683,2
00019373_036.png,36,916,49,861,631,803,754,915,0
00017500_002.png,100,926,56,842,665,771,715,832,0
00017500_002.png,100,926,56,842,11,209,153,480,2
00016009_008.png,113,910,46,941,459,613,567,862,0
00013111_069.png,43,922,15,894,431,575,560,833,0
00023156_001.png,145,963,46,884,84,238,192,353,0
00013508_001.png,93,936,54,915,230,407,353,498,0
00013508_001.png,93,936,54,915,193,282,228,375,4
00008554_009.png,15,931,33,846,591,820,787,986,0
00017582_003.png,71,962,51,787,185,384,333,527,0
00017582_003.png,71,962,51,787,36,150,99,459,2
00009619_000.png,43,947,0,940,257,365,365,477,0
00009437_008.png,91,933,68,889,661,824,756,902,0
00009437_008.png,91,933,68,889,652,839,771,1116,2
00013992_006.png,46,967,22,951,234,362,340,442,0
00001836_082.png,82,910,96,1002,88,251,155,360,0
00001836_082.png,82,910,96,1002,254,393,297,507,4
00021024_022.png,137,1005,29,924,582,744,715,934,0
00029940_007.png,0,884,66,865,212,356,290,539,0
00011827_003.png,110,900,0,874,458,764,764,887,0
00011827_003.png,110,900,0,874,642,770,770,1354,2
00019154_002.png,54,986,1,787,239,370,369,586,0
00003440_000.png,121,877,64,808,96,219,155,299,0
00003440_000.png,121,877,64,808,470,584,520,697,4
00009256_005.png,68,918,27,726,237,348,321,462,0
00014447_004.png,116,904,70,836,96,259,189,355,0
00014447_004.png,116,904,70,836,38,132,62,400,2
00012834_008.png,0,1016,0,776,111,309,309,381,0
00012834_008.png,0,1016,0,776,5,279,279,700,2
00016987_019.png,76,928,59,866,188,295,236,371,0
00020393_003.png,66,942,7,735,615,836,829,932,0
00020393_003.png,66,942,7,735,616,868,861,1052,2
00029502_006.png,61,970,29,927,160,411,382,589,0
00029502_006.png,61,970,29,927,87,343,314,736,2
00000457_004.png,115,1023,0,957,687,780,780,885,0
00027556_007.png,0,847,0,917,172,310,310,424,0
00027556_007.png,0,847,0,917,70,240,240,476,4
00005089_014.png,64,928,68,845,115,253,185,324,0
00005089_014.png,64,928,68,845,580,808,740,1403,2
00007710_000.png,17,929,29,908,607,823,794,909,0
00012637_000.png,45,957,72,857,683,815,743,898,0
00000147_001.png,97,944,45,830,520,620,575,799,0
00018427_004.png,0,942,60,905,94,271,211,343,0
00018427_004.png,0,942,60,905,770,954,894,1502,2
00018427_004.png,0,942,60,905,532,639,579,739,4
00014663_013.png,62,981,79,1024,291,427,348,622,0
00014795_002.png,58,954,0,907,231,379,379,512,0
00028625_000.png,103,905,51,861,235,355,304,451,0
00019271_065.png,41,927,90,868,170,311,221,421,0
00014095_003.png,147,963,52,796,149,321,269,415,0
00023116_005.png,0,947,24,965,641,820,796,978,0
00009779_001.png,93,923,0,753,618,780,780,849,0
00012829_004.png,68,891,39,864,101,268,229,361,0
00006948_002.png,114,903,33,888,619,745,712,837,0
00029200_006.png,0,989,84,898,132,288,204,402,0
00022707_003.png,0,939,52,896,754,926,874,998,0
00008716_000.png,63,905,74,943,644,795,721,899,0
00000072_000.png,54,1024,122,1015,302,429,307,511,0
00002350_001.png,144,919,4,716,582,730,726,818,0
00004296_000.png,0,932,43,1008,731,850,807,943,0
00029631_006.png,24,954,42,915,95,266,224,371,0
00000643_002.png,52,982,87,744,766,862,775,936,0
00015831_008.png,122,947,85,837,499,617,532,780,0
00020429_020.png,48,943,60,870,118,300,240,385,0
00015300_000.png,63,1024,77,811,108,255,178,402,0
00015300_000.png,63,1024,77,811,152,228,151,281,4
00002856_009.png,47,949,51,869,170,386,335,487,0
00028620_000.png,50,964,45,916,748,901,856,984,0
00021377_016.png,75,934,37,915,648,822,785,923,0
00000830_000.png,10,950,76,730,565,845,769,960,0
00000830_000.png,10,950,76,730,299,395,319,515,4
00016490_011.png,36,894,13,835,147,314,301,377,0
00001673_016.png,111,884,61,905,170,220,159,320,0
00015440_000.png,124,925,14,886,512,664,650,732,0
00015440_000.png,124,925,14,886,51,358,344,872,4
00025270_000.png,67,925,72,849,201,300,228,367,0
00012636_000.png,49,939,70,912,726,845,775,914,0
00027697_001.png,67,950,7,821,642,835,828,892,0
00027697_001.png,67,950,7,821,91,401,394,611,4
00021862_004.png,10,955,46,956,597,715,669,850,0
00016987_022.png,0,991,67,698,83,380,313,501,0
00018419_001.png,16,932,27,846,730,845,818,897,0
00007120_009.png,129,907,65,848,120,256,191,342,0
00030260_004.png,47,921,41,983,321,378,337,600,0
00020810_003.png,49,967,75,1024,110,368,293,481,0
00005066_030.png,70,952,15,949,207,747,732,1048,1
00005066_030.png,70,952,15,949,79,106,91,171,2
00005066_030.png,70,952,15,949,461,703,688,866,3
00009608_024.png,90,916,13,925,304,669,656,1010,1
00000661_000.png,0,972,66,933,298,846,780,1274,1
00000211_041.png,53,913,16,918,171,683,667,1113,1
00015770_010.png,91,936,41,911,272,723,682,994,1
00011463_002.png,90,932,23,930,289,731,708,1073,1
00021364_001.png,17,974,33,893,318,813,780,1118,1
00003394_006.png,0,972,49,784,312,753,704,1056,1
00016990_000.png,0,916,56,911,312,770,714,1071,1
00027797_000.png,21,964,44,920,409,903,859,1225,1
00013670_151.png,91,1024,45,923,346,808,763,1142,1
00013670_151.png,91,1024,45,923,171,850,805,1330,3
00011322_006.png,69,943,37,859,296,777,740,1091,1
00018387_030.png,99,948,0,735,289,784,784,1079,1
00018387_030.png,99,948,0,735,59,828,828,988,2
00007037_000.png,0,913,0,1011,289,789,789,1174,1
00017448_000.png,39,945,70,1003,316,794,724,1186,1
00029808_003.png,13,921,36,960,308,754,718,1148,1
00029808_003.png,13,921,36,960,597,793,757,1095,6
00014706_018.png,70,955,40,871,300,724,684,1014,1
00007551_020.png,78,925,50,965,274,732,682,1081,1
00021009_001.png,25,980,40,756,293,752,712,1062,1
00021009_001.png,25,980,40,756,129,759,719,1311,3
00000377_004.png,108,1024,41,914,279,781,740,1148,1
00019426_000.png,149,1001,46,866,299,694,648,966,1
00005066_005.png,96,920,33,883,235,742,709,1090,1
00004630_001.png,0,886,25,870,284,796,771,1139,1
00028509_026.png,42,958,36,881,268,773,737,1116,1
00002435_005.png,70,952,27,929,292,693,666,991,1
00026087_000.png,0,875,47,949,338,755,708,1148,1
00021409_001.png,125,917,25,911,187,679,654,1066,1
00012288_000.png,103,916,64,840,252,697,633,962,1
00006912_007.png,0,985,0,914,330,770,770,1096,1
00005532_016.png,53,900,48,912,272,685,637,1025,1
00020986_000.png,62,962,29,830,356,797,768,1088,1
00016624_000.png,0,936,0,953,552,920,920,1250,1
00017511_006.png,78,888,27,906,260,657,630,991,1
00016564_000.png,108,914,77,744,276,728,651,1032,1
00012741_004.png,97,1024,46,876,345,791,745,1198,1
00028018_000.png,48,931,77,1008,305,760,683,1188,1
00017178_007.png,7,946,15,786,338,783,768,1161,1
00029906_000.png,44,913,58,939,286,718,660,1033,1
00000732_005.png,75,944,21,931,352,764,743,1108,1
00000732_005.png,75,944,21,931,538,710,689,813,7
00012670_000.png,153,988,59,848,274,703,644,1019,1
00026338_003.png,95,938,0,832,257,696,696,1010,1
00013062_002.png,96,918,0,865,256,654,654,1049,1
00002763_031.png,146,1010,44,830,256,732,688,1119,1
00013346_015.png,95,929,19,960,278,737,718,1258,1
00014626_028.png,116,925,31,855,216,654,623,1055,1
00026889_000.png,0,961,17,960,237,830,813,1283,1
00000211_019.png,27,943,22,943,313,814,792,1220,1
00023325_019.png,90,915,34,745,254,731,697,1081,1
00011502_001.png,129,901,62,798,313,679,617,1060,1
00018233_057.png,119,909,56,857,228,639,583,986,1
00012261_001.png,46,1024,47,865,407,939,892,1358,1
00012261_001.png,46,1024,47,865,582,823,776,1039,6
00014706_007.png,69,925,31,779,333,705,674,1051,1
00028873_009.png,83,903,26,897,250,644,618,1000,1
00023093_009.png,94,936,25,726,339,726,701,998,1
00017893_005.png,92,964,29,945,294,785,756,1191,1
00028873_004.png,58,902,41,875,263,702,661,1037,1
00004461_000.png,0,844,31,940,329,741,710,1088,1
00008365_000.png,51,917,72,956,286,703,631,1106,1
00004381_021.png,114,922,42,874,275,727,685,1053,1
00002704_029.png,10,917,41,731,323,769,728,1136,1
00012364_006.png,0,864,0,938,325,755,755,1136,1
00022215_012.png,47,932,38,845,276,788,750,1205,1
00022215_012.png,47,932,38,845,581,768,730,1000,6
00017524_028.png,0,890,70,888,251,748,678,1178,1
00005827_000.png,90,950,16,861,303,754,738,1225,1
00001534_005.png,53,961,22,748,343,833,811,1214,1
00004344_022.png,91,951,48,941,285,750,702,1124,1
00020819_002.png,88,942,69,757,280,774,705,1170,1
00005532_014.png,51,898,52,907,287,748,696,1094,1
00004342_020.png,95,935,102,963,221,695,593,1126,1
00022215_011.png,25,927,22,906,369,859,837,1215,1
00015563_011.png,51,915,49,907,269,769,720,1219,1
00018686_000.png,62,954,0,930,291,788,788,1240,1
00011263_004.png,39,945,47,954,273,828,781,1311,1
00013249_052.png,19,937,23,763,315,837,814,1128,1
00016606_000.png,110,900,23,908,257,744,721,1123,1
00025747_000.png,18,963,42,825,317,811,769,1178,1
00027464_033.png,6,933,11,707,289,809,798,1204,1
00022416_018.png,59,964,70,819,298,865,795,1218,1
00004534_001.png,0,897,60,942,256,806,746,1222,1
00004344_018.png,74,941,22,907,317,821,799,1251,1
00027685_003.png,79,913,28,832,261,730,702,1111,1
00009745_000.png,57,907,41,938,272,728,687,1110,1
00029391_000.png,46,900,54,848,269,754,700,1131,1
00000740_000.png,71,918,40,870,230,706,666,1092,1
00011322_002.png,102,916,18,913,244,751,733,1236,1
00009705_000.png,53,982,36,701,285,827,791,1197,1
00004344_046.png,149,1009,3,899,219,699,696,1072,1
00021845_001.png,90,877,51,899,217,604,553,968,1
00000845_000.png,103,916,48,890,267,721,673,1145,1
00000398_003.png,64,910,23,833,305,789,766,1165,1
00021443_000.png,0,959,68,918,286,831,763,1246,1
00008339_010.png,30,939,47,856,318,843,796,1229,1
00017514_008.png,47,976,80,880,299,835,755,1170,1
00015400_001.png,104,910,9,941,195,673,664,1082,1
00013125_000.png,12,956,40,852,157,819,779,1237,1
00007735_040.png,154,1024,120,977,245,786,666,1233,1
00025732_004.png,63,821,36,880,155,692,656,1108,1
00018693_004.png,67,926,60,922,233,781,721,1180,1
00015425_012.png,82,955,57,645,303,748,691,1104,1
00013635_002.png,112,924,50,787,251,713,663,1082,1
00007043_000.png,15,927,27,883,276,805,778,1243,1
00001369_000.png,0,991,60,708,336,889,829,1275,1
00015799_012.png,37,954,51,831,323,846,795,1244,1
00002059_008.png,32,947,68,908,342,896,828,1260,1
00020438_011.png,75,921,0,893,254,740,740,1220,1
00014574_000.png,98,911,42,897,271,708,666,1103,1
00012793_000.png,21,973,61,897,332,826,765,1230,1
00012094_006.png,128,1024,39,930,275,688,649,1092,1
00004533_014.png,92,935,20,906,358,806,786,1198,1
00019187_000.png,141,915,34,868,255,719,685,1103,1
00001373_009.png,76,956,18,957,336,884,866,1385,1
00016414_000.png,45,983,30,954,340,911,881,1360,1
00030279_000.png,0,893,41,932,289,836,795,1293,1
00010381_000.png,100,918,43,829,290,745,702,1104,1
00004344_013.png,122,911,8,878,228,753,745,1175,1
00019861_010.png,12,934,65,841,257,791,726,1187,1
00022706_001.png,72,903,26,890,275,724,698,1111,1
00004344_014.png,91,910,7,876,238,705,698,1155,1
00015064_001.png,159,1024,106,1024,220,823,717,1339,1
00011557_003.png,27,937,56,960,319,827,771,1209,1
00029647_002.png,38,929,56,920,297,791,735,1177,1
00018187_029.png,62,943,73,906,280,792,719,1252,1
00004342_023.png,122,920,72,915,220,675,603,1053,1
00004342_002.png,0,802,64,974,200,677,613,1155,1
00015719_005.png,11,930,0,1003,341,841,841,1384,1
00028607_000.png,68,961,33,889,336,833,800,1276,1
00004893_085.png,117,915,45,819,268,731,686,1120,1
00001373_039.png,11,867,69,926,249,812,743,1302,1
00000756_001.png,0,970,13,820,289,890,877,1320,1
00008522_032.png,55,909,0,723,260,694,694,1088,1
00005532_000.png,51,975,32,661,331,806,774,1219,1
00030206_013.png,0,991,50,809,312,777,727,1210,1
00008399_007.png,32,968,75,769,331,878,803,1249,1
00012686_003.png,36,980,85,822,289,825,740,1228,1
00004822_051.png,103,941,22,936,255,778,756,1172,1
00015304_001.png,0,953,49,817,290,906,857,1400,1
00010172_001.png,76,940,56,858,112,159,103,210,2
00010007_168.png,31,976,17,960,302,356,339,475,2
00010828_039.png,0,994,59,770,702,940,881,1177,2
00010828_039.png,0,994,59,770,666,916,857,1162,3
00010828_039.png,0,994,59,770,588,801,742,1028,0
00027479_013.png,67,955,15,764,706,891,876,959,2
00027479_013.png,67,955,15,764,172,855,840,1347,3
00018253_059.png,88,930,6,954,91,293,287,588,2
00018253_059.png,88,930,6,954,94,296,290,605,3
00018253_059.png,88,930,6,954,97,300,294,587,0
00029579_005.png,43,898,65,855,61,88,23,151,2
00029579_005.png,43,898,65,855,566,639,574,710,4
00021703_001.png,9,925,34,920,554,762,728,917,2
00021703_001.png,9,925,34,920,104,262,228,317,3
00021703_001.png,9,925,34,920,127,743,709,955,0
00013993_077.png,96,938,9,926,71,272,263,495,2
00013993_077.png,96,938,9,926,112,684,675,1076,6
00018102_001.png,23,991,63,787,84,122,59,175,2
00000344_003.png,119,919,50,881,53,150,100,371,2
00020482_032.png,0,865,17,931,430,712,695,973,2
00020482_032.png,0,865,17,931,469,697,680,957,3
00020482_032.png,0,865,17,931,482,692,675,1053,0
00029464_015.png,0,888,69,900,719,910,841,961,2
00029464_015.png,0,888,69,900,198,813,744,1136,0
00028383_002.png,70,901,38,932,709,795,757,851,2
00028383_002.png,70,901,38,932,94,350,312,883,3
00015078_013.png,14,974,29,897,48,949,920,1182,2
00020000_000.png,0,829,58,976,543,764,706,1052,2
00020000_000.png,0,829,58,976,270,358,300,386,7
00010277_000.png,43,941,40,933,820,892,852,1004,2
00010277_000.png,43,941,40,933,590,861,821,1082,3
00010277_000.png,43,941,40,933,254,794,754,1071,4
00010277_000.png,43,941,40,933,599,864,824,1087,6
00030634_000.png,99,936,77,802,42,359,282,455,2
00018427_011.png,0,950,51,874,595,898,847,999,2
00016837_002.png,51,924,46,858,89,347,301,409,2
00016837_002.png,51,924,46,858,89,360,314,454,0
00013285_026.png,96,955,19,905,82,121,102,387,2
00019767_016.png,31,963,85,853,97,415,330,501,2
00018366_029.png,33,883,57,785,527,778,721,843,2
00018366_029.png,33,883,57,785,562,764,707,959,7
00003803_010.png,120,883,45,865,51,690,645,823,2
00027028_017.png,65,932,42,899,85,856,814,994,2
00020213_078.png,64,947,70,854,120,358,288,458,2
00021840_016.png,41,1003,90,837,101,342,252,439,2
00021840_016.png,41,1003,90,837,119,387,297,574,3
00021711_014.png,104,936,85,843,446,798,713,920,2
00015090_006.png,51,921,53,939,587,783,730,960,2
00015090_006.png,51,921,53,939,540,785,732,986,6
00025686_000.png,20,951,49,920,576,908,859,1012,2
00017188_002.png,108,946,74,693,91,319,245,410,2
00028518_021.png,85,919,44,910,99,284,240,389,2
00023058_004.png,0,968,70,903,38,355,285,557,2
00026810_001.png,75,922,58,890,691,810,752,865,2
00012045_009.png,57,933,37,812,659,760,723,877,2
00025252_053.png,0,886,3,953,14,350,347,510,2
00025252_053.png,0,886,3,953,650,795,792,1057,7
00021972_001.png,101,909,21,871,42,335,314,456,2
00016291_002.png,105,951,42,887,512,838,796,916,2
00021381_013.png,146,902,71,796,417,699,628,787,2
00021181_002.png,93,924,66,709,57,342,276,549,2
00014015_003.png,58,937,70,879,47,322,252,500,2
00016964_011.png,19,877,54,704,710,802,748,861,2
00007882_001.png,61,934,35,998,89,291,256,349,2
00015058_024.png,42,934,72,892,545,853,781,949,2
00008547_001.png,37,964,75,891,769,912,837,1053,2
00020274_007.png,134,899,38,824,653,722,684,868,2
00020274_007.png,134,899,38,824,165,263,225,372,4
00014976_003.png,113,913,59,801,494,736,677,815,2
00030408_013.png,21,985,31,924,697,816,785,960,2
00030408_013.png,21,985,31,924,123,342,311,492,3
00030412_001.png,99,923,38,888,100,197,159,499,2
00025252_040.png,42,938,79,1024,558,820,741,1237,2
00019766_023.png,44,910,26,917,690,882,856,1197,2
00013750_016.png,0,981,87,897,197,389,302,664,2
00017138_037.png,35,964,16,934,83,273,257,755,2
00017138_037.png,35,964,16,934,158,379,363,814,3
00002583_014.png,0,944,63,853,608,926,863,1333,2
00028640_008.png,45,923,72,894,718,851,779,1117,2
00028640_008.png,45,923,72,894,204,401,329,613,3
00019924_020.png,26,947,5,953,605,793,788,1172,2
00020405_041.png,96,933,24,948,14,213,189,592,2
00020405_041.png,96,933,24,948,493,753,729,1138,3
00018253_054.png,74,930,14,944,108,355,341,859,2
00018253_054.png,74,930,14,944,186,385,371,574,3
00021967_000.png,148,1021,29,886,34,399,370,985,2
00030039_008.png,0,873,28,894,26,290,262,917,2
00012834_122.png,68,928,36,951,8,266,230,1139,2
00025521_003.png,60,916,67,892,12,119,52,379,2
00025521_003.png,60,916,67,892,530,771,704,915,3
00026753_008.png,0,856,44,906,598,901,857,1582,2
00012174_000.png,136,912,21,795,33,221,200,760,2
00020751_003.png,73,959,62,917,673,922,860,1579,2
00002533_002.png,57,909,0,837,223,432,432,966,2
00012505_007.png,52,947,42,777,202,440,398,972,2
00012505_007.png,52,947,42,777,288,475,433,711,3
00014346_010.png,115,922,51,867,38,324,273,938,2
00025228_007.png,105,921,66,850,14,154,88,455,2
00018980_002.png,140,899,40,738,107,286,246,507,2
00023283_019.png,16,933,72,895,33,187,115,655,2
00027357_014.png,37,937,32,886,25,287,255,932,2
00027357_014.png,37,937,32,886,615,751,719,947,3
00016417_008.png,69,949,40,922,716,898,858,1517,2
00016417_008.png,69,949,40,922,128,382,342,558,3
00027441_002.png,60,902,44,872,61,278,234,840,2
00027441_002.png,60,902,44,872,149,334,290,622,3
00014738_000.png,95,906,57,807,95,345,288,924,2
00014738_000.png,95,906,57,807,144,393,336,773,3
00013993_083.png,91,955,66,901,46,300,234,996,2
00013993_083.png,91,955,66,901,504,756,690,1082,3
00022572_005.png,78,964,38,968,66,296,258,774,2
00017403_006.png,0,879,41,957,594,785,744,1089,2
00023093_007.png,107,916,61,795,584,809,748,1150,2
00016291_019.png,24,966,23,964,128,403,380,766,2
00016522_023.png,69,933,35,911,67,403,368,1047,2
00012973_005.png,24,964,6,891,98,377,371,1139,2
00025664_002.png,50,941,33,941,16,292,259,922,2
00014149_018.png,46,842,76,803,613,778,702,1044,2
00028774_047.png,29,932,39,863,24,208,169,516,2
00029894_000.png,47,921,18,870,668,897,879,1114,2
00022572_063.png,53,931,65,902,17,299,234,618,2
00009218_015.png,65,914,11,870,128,349,338,941,2
00022899_000.png,0,923,27,873,716,938,911,1254,2
00027817_001.png,51,919,24,898,709,906,882,1273,2
00018657_003.png,71,916,53,783,652,822,769,1115,2
00003072_028.png,14,957,59,831,10,294,235,743,2
00014626_035.png,103,921,96,1003,47,262,166,1047,2
00011269_019.png,54,921,57,846,679,896,839,1085,2
00011269_019.png,54,921,57,846,518,649,592,792,4
00007034_016.png,50,897,42,896,717,806,764,981,2
00020277_001.png,49,934,59,845,644,846,787,1239,2
00013977_005.png,16,936,50,1024,765,889,839,1069,2
00014398_031.png,74,941,21,751,115,303,282,630,2
00029469_011.png,51,912,88,1024,673,845,757,1296,2
00028509_007.png,30,911,63,855,19,227,164,790,2
00027875_005.png,0,890,49,656,696,962,913,1364,2
00013337_000.png,26,980,64,958,35,312,248,760,2
00013031_005.png,0,932,68,928,19,179,111,573,2
00001558_016.png,33,967,41,859,52,279,238,695,2
00005089_040.png,44,954,30,901,574,824,794,1503,2
00028974_016.png,83,929,22,876,686,850,828,1046,2
00025529_018.png,85,909,58,728,639,823,765,1426,2
00025529_018.png,85,909,58,728,618,728,670,856,4
00027631_000.png,0,972,91,899,837,946,855,1087,2
00017124_004.png,71,949,0,941,721,885,885,1326,2
00020564_000.png,2,900,35,686,773,886,851,1126,2
00015895_017.png,45,917,27,958,674,831,804,1353,2
00029588_004.png,48,914,19,963,-7,258,239,823,2
00021860_002.png,101,920,68,880,-1,142,74,352,2
00027103_001.png,143,998,114,1011,529,732,618,1001,2
00009342_000.png,80,971,69,737,778,931,862,1184,2
00016972_025.png,10,928,16,861,679,799,783,995,2
00027577_003.png,0,860,48,822,94,230,182,496,2
00019399_010.png,21,969,20,759,762,895,875,1144,2
00001437_012.png,140,1004,40,839,-57,296,256,912,2
00021132_000.png,105,906,26,812,600,760,734,1235,2
00018360_035.png,63,937,77,863,654,875,798,1166,2
00030128_002.png,102,928,55,919,20,243,188,663,2
00020259_002.png,106,934,57,837,505,754,697,953,3
00020259_002.png,106,934,57,837,508,731,674,928,6
00022727_000.png,138,891,58,710,68,750,692,1169,3
00028208_005.png,137,1022,5,998,135,832,827,1242,3
00028208_005.png,137,1022,5,998,142,825,820,1202,6
00018393_000.png,96,921,1,853,508,684,683,881,3
00018393_000.png,96,921,1,853,517,677,676,878,6
00029861_013.png,95,927,20,850,98,706,686,1207,3
00029861_013.png,95,927,20,850,106,710,690,1240,6
00006836_002.png,0,937,23,882,298,786,763,966,3
00027927_008.png,120,1010,42,863,109,312,270,525,3
00010120_010.png,95,945,23,992,130,816,793,1216,3
00010120_010.png,95,945,23,992,111,802,779,1260,6
00014251_029.png,80,929,26,881,51,803,777,1352,3
00022470_006.png,150,1012,31,973,42,780,749,1406,3
00011925_072.png,96,915,0,909,176,362,362,726,3
00011925_072.png,96,915,0,909,281,442,442,847,4
00019625_002.png,101,927,14,895,89,745,731,1154,3
00015069_001.png,108,907,7,893,63,749,742,1280,3
00015069_001.png,108,907,7,893,93,742,735,1250,6
00017544_003.png,39,955,60,900,546,834,774,1418,3
00013391_005.png,24,946,69,847,66,369,300,687,3
00013391_005.png,24,946,69,847,77,384,315,748,6
00021201_010.png,68,951,68,1004,616,831,763,1264,3
00021201_010.png,68,951,68,1004,647,802,734,1119,4
00029039_020.png,63,946,26,924,99,769,743,1324,3
00016705_006.png,13,846,52,872,678,773,721,1010,3
00016705_006.png,13,846,52,872,683,774,722,1009,6
00019750_012.png,28,990,58,718,112,825,767,1260,3
00013310_057.png,50,917,75,1020,66,786,711,1391,3
00028285_014.png,73,899,10,960,563,797,787,1157,3
00028285_014.png,73,899,10,960,587,797,787,1130,6
00023026_008.png,99,929,57,1024,83,787,730,1187,3
00012376_010.png,153,991,68,894,80,307,239,563,3
00012376_010.png,153,991,68,894,588,713,645,1136,4
00012376_010.png,153,991,68,894,221,340,272,395,7
00010092_018.png,53,931,46,794,558,664,618,881,3
00012021_054.png,87,927,55,916,497,721,666,1189,3
00016191_004.png,58,910,16,901,187,389,373,553,3
00030573_002.png,28,938,64,828,575,731,667,914,3
00017714_009.png,62,943,13,940,630,792,779,957,3
00020184_013.png,65,950,52,863,89,320,268,568,3
00014617_003.png,106,1024,32,913,301,485,453,659,3
00016094_007.png,16,983,76,883,162,283,207,417,3
00009431_004.png,91,924,39,967,540,730,691,1151,3
00001039_005.png,82,936,39,917,506,716,677,995,3
00029617_006.png,110,902,38,916,505,721,683,887,3
00028640_003.png,0,871,64,897,569,744,680,908,3
00017083_002.png,32,951,21,674,126,319,298,542,3
00003973_008.png,97,895,72,869,79,300,228,497,3
00006304_060.png,74,964,28,916,624,797,769,1051,3
00017972_032.png,87,960,5,914,99,349,344,781,3
00021710_003.png,44,949,32,944,554,760,728,942,3
00000211_016.png,96,914,27,876,141,371,344,699,3
00019363_043.png,0,845,71,899,476,716,645,950,3
00006096_010.png,36,960,82,862,91,395,313,534,3
00003333_002.png,23,915,53,729,494,822,769,1172,3
00011269_018.png,67,917,24,704,511,728,704,1011,3
00016786_009.png,86,938,81,1024,408,653,572,918,3
00013106_000.png,65,946,57,1024,572,808,751,1280,3
00019706_012.png,96,908,51,795,114,319,268,444,3
00015831_011.png,36,936,101,968,537,794,693,1071,3
00020482_011.png,73,956,0,993,427,620,620,900,3
00016732_040.png,91,935,13,958,117,275,262,462,3
00021926_007.png,138,915,57,890,185,336,279,526,3
00017981_014.png,139,984,76,804,115,310,234,449,3
00000468_041.png,150,998,67,888,116,228,161,300,3
00026538_034.png,0,850,55,881,501,687,632,909,3
00027113_002.png,20,960,28,933,600,848,820,1247,3
00010230_001.png,40,909,22,882,637,804,782,944,3
00007124_006.png,0,964,68,758,580,897,829,1256,3
00013922_022.png,14,981,28,864,545,779,751,1022,3
00022899_014.png,0,874,19,969,87,324,305,713,3
00001900_026.png,0,896,99,773,578,812,713,1103,3
00000032_037.png,57,921,0,758,282,454,454,805,3
00019150_002.png,83,941,51,932,564,808,757,1278,3
00026865_003.png,48,880,80,816,575,768,688,937,3
00019634_004.png,66,951,37,879,631,846,809,1104,3
00026098_003.png,25,841,59,918,125,351,292,563,3
00018721_010.png,89,955,14,907,150,402,388,605,3
00019646_006.png,45,945,38,893,547,804,766,1019,3
00019750_029.png,0,988,72,808,673,871,799,1103,3
00013471_029.png,82,950,36,934,538,765,729,1132,3
00002224_007.png,5,833,57,891,211,389,332,684,3
00011023_004.png,163,971,22,927,138,334,312,582,3
00014203_018.png,11,981,20,893,543,720,700,926,3
00011124_000.png,67,916,43,947,174,288,245,414,3
00019769_014.png,112,922,53,912,511,680,627,873,3
00016786_001.png,0,869,0,926,564,788,788,1278,3
00012364_045.png,102,930,105,969,480,695,590,1051,3
00026538_012.png,112,930,1,883,519,703,702,899,3
00023075_033.png,98,1024,46,992,141,213,167,278,4
00013659_019.png,81,952,18,934,478,580,562,716,4
00013659_019.png,81,952,18,934,469,640,622,915,6
00013659_019.png,81,952,18,934,210,316,298,366,7
00010815_006.png,19,959,88,995,292,438,350,694,4
00010815_006.png,19,959,88,995,292,445,357,689,0
00026695_000.png,0,951,44,852,341,458,414,589,4
00010125_004.png,0,988,70,759,147,212,142,299,4
00026261_001.png,39,932,63,905,157,394,331,632,4
00019313_000.png,22,980,99,1019,727,824,725,930,4
00018623_001.png,35,925,82,884,242,854,772,1112,4
00020124_003.png,69,945,71,857,292,398,327,533,4
00020124_003.png,69,945,71,857,106,350,279,453,0
00026196_001.png,35,1009,73,882,358,441,368,521,4
00026196_001.png,35,1009,73,882,280,419,346,581,6
00028698_001.png,54,954,103,1010,796,857,754,1026,4
00016184_040.png,70,954,54,894,628,672,618,723,4
00017214_015.png,60,922,30,960,553,632,602,775,4
00020065_008.png,78,975,65,1024,740,827,762,968,4
00013911_021.png,32,939,0,942,67,765,765,1303,4
00021179_011.png,58,932,70,998,66,420,350,1086,4
00006821_002.png,85,1024,15,965,36,417,402,1091,4
00011151_004.png,52,948,15,965,279,654,639,1019,4
00027833_022.png,0,969,6,908,300,890,884,1332,4
00028265_007.png,43,973,89,1024,756,841,752,941,4
00028027_000.png,7,933,18,902,568,686,668,830,4
00018762_001.png,85,839,65,901,598,679,614,756,4
00018366_010.png,51,913,35,796,662,795,760,994,4
00022837_005.png,86,932,49,702,662,759,710,877,4
00008008_027.png,50,954,30,930,596,691,661,794,4
00001787_008.png,56,913,35,829,205,651,616,874,4
00017257_001.png,49,943,88,1019,377,694,606,1044,4
00029105_015.png,32,905,55,919,196,316,261,438,4
00012376_011.png,158,1005,74,908,612,686,612,764,4
00012975_003.png,65,956,31,854,141,347,316,549,4
00011157_001.png,80,944,44,869,121,246,202,366,4
00023168_000.png,3,954,110,981,212,306,196,429,4
00016568_010.png,82,919,40,886,608,716,676,839,4
00014731_028.png,141,1014,53,827,632,744,691,884,4
00019651_002.png,92,928,30,854,536,735,705,935,4
00011291_003.png,88,948,32,826,605,793,761,996,4
00019499_000.png,37,971,62,1024,686,797,735,894,4
00005532_019.png,51,899,52,895,632,702,650,760,4
00030323_015.png,92,932,20,841,523,748,728,1038,4
00014014_013.png,146,992,52,847,503,673,621,843,4
00011925_077.png,76,960,0,950,204,505,505,976,4
00014177_010.png,52,949,12,960,137,263,251,494,4
00028628_020.png,88,914,60,885,538,642,582,726,4
00018101_012.png,60,936,36,847,112,370,334,693,4
00012892_010.png,128,1009,0,910,246,351,351,485,4
00017670_005.png,77,935,66,826,291,411,345,559,4
00019373_058.png,26,965,12,981,299,422,410,579,4
00014004_038.png,106,953,16,898,238,348,332,485,4
00028330_003.png,0,854,98,1024,209,355,257,550,4
00015649_000.png,6,966,33,882,635,719,686,793,4
00021420_020.png,28,930,43,945,138,230,187,321,4
00022192_003.png,69,948,74,920,106,368,294,671,4
00022237_002.png,38,917,20,965,231,357,337,458,4
00022726_002.png,88,922,106,1010,600,727,621,847,4
00011925_076.png,0,861,4,886,123,418,414,792,4
00017611_002.png,116,928,87,999,142,304,217,452,4
00029469_007.png,76,920,90,1024,768,929,839,1122,4
00014551_010.png,40,886,50,682,547,704,654,883,4
00009229_007.png,109,958,49,916,614,682,633,755,4
00012270_005.png,32,946,0,1006,711,823,823,934,4
00013991_000.png,111,953,70,752,270,376,306,471,4
00012048_007.png,0,972,74,1012,287,434,360,585,4
00001075_024.png,17,973,10,728,273,426,416,624,4
00012175_008.png,80,949,50,803,261,398,348,534,4
00000902_001.png,23,967,128,965,328,416,288,500,4
00001688_000.png,45,996,0,833,622,744,744,894,5
00004547_003.png,0,1007,0,963,899,952,952,1010,5
00023078_000.png,38,972,79,1022,703,755,676,803,5
00013911_000.png,13,891,53,912,105,190,137,291,5
00027927_009.png,53,923,28,913,686,738,710,799,5
00014116_009.png,6,964,24,915,690,744,720,801,5
00019058_004.png,70,922,44,896,280,372,328,512,5
00016487_002.png,0,993,77,936,640,727,650,806,5
00015794_000.png,0,988,81,849,68,116,35,160,5
00012374_000.png,52,938,100,1009,603,685,585,765,5
00003948_001.png,71,933,57,877,210,312,255,439,5
00018366_000.png,44,950,96,1024,146,209,113,278,5
00014778_000.png,113,1024,79,1024,124,176,97,224,5
00026221_001.png,40,958,88,1024,159,261,173,376,5
00026221_001.png,40,958,88,1024,97,416,328,922,7
00015792_005.png,13,939,71,993,254,333,262,411,5
00030394_001.png,80,936,0,992,543,609,609,667,5
00001555_002.png,115,917,85,1024,499,573,488,648,5
00028876_060.png,103,916,24,944,660,734,710,820,5
00014280_000.png,70,975,9,975,749,801,792,858,5
00006736_000.png,22,976,69,880,748,793,724,839,5
00022977_000.png,56,917,44,936,185,251,207,314,5
00018984_000.png,54,933,27,935,771,843,816,958,5
00026319_000.png,117,930,7,914,551,672,665,751,5
00008386_000.png,45,909,62,964,666,724,662,771,5
00006751_000.png,0,961,58,817,175,249,191,315,5
00001836_041.png,91,931,40,949,535,567,527,593,5
00020274_021.png,45,917,68,882,114,214,146,282,5
00026983_001.png,117,876,68,864,435,503,435,575,5
00026132_016.png,104,913,16,908,597,677,661,751,5
00013673_001.png,0,987,97,872,150,231,134,301,5
00004911_018.png,137,982,30,804,558,658,628,746,5
00026769_010.png,9,965,90,886,783,838,748,891,5
00013051_000.png,44,936,116,963,222,280,164,337,5
00020332_000.png,33,989,0,989,196,270,270,333,5
00017243_010.png,0,887,22,937,76,164,142,247,5
00017243_010.png,0,887,22,937,21,145,123,709,7
00025662_006.png,36,954,24,938,791,841,817,898,5
00027470_006.png,118,938,9,867,281,375,366,448,5
00019013_002.png,41,948,46,953,742,790,744,835,5
00015141_002.png,23,959,49,877,773,823,774,889,5
00026398_000.png,129,900,0,949,235,283,283,329,5
00021374_000.png,29,983,52,1024,717,838,786,943,5
00017199_005.png,85,935,29,972,688,758,729,832,5
00015583_000.png,73,920,98,976,605,652,554,687,5
00017098_003.png,79,925,122,994,221,279,157,355,5
00019177_000.png,82,970,11,918,200,298,287,408,5
00030162_029.png,42,934,57,1024,285,353,296,426,5
00030162_029.png,42,934,57,1024,579,782,725,941,7
00026285_000.png,38,998,67,940,867,914,847,961,5
00002578_000.png,0,1024,130,926,796,874,744,933,5
00013951_001.png,109,933,0,987,192,254,254,303,5
00020393_001.png,0,975,62,897,237,312,250,382,5
00015018_004.png,93,966,41,962,712,767,726,824,5
00011832_002.png,24,936,88,1024,720,790,702,863,5
00021420_014.png,111,967,49,829,676,746,697,822,5
00017346_000.png,0,967,66,1024,873,901,835,934,5
00010959_010.png,88,923,61,886,124,203,142,263,5
00013885_000.png,119,906,53,841,317,360,307,404,5
00020774_000.png,47,990,0,987,182,242,242,304,5
00028876_035.png,99,919,10,903,91,156,146,228,5
00017028_000.png,0,974,37,934,145,221,184,279,5
00009403_006.png,60,917,25,664,688,763,738,815,5
00021772_016.png,55,904,10,939,116,207,197,289,5
00019124_090.png,113,919,40,828,543,638,598,713,5
00016587_069.png,61,979,66,885,694,764,698,822,5
00009403_002.png,19,910,40,875,626,698,658,770,5
00012415_002.png,113,901,57,885,285,359,302,445,5
00011450_000.png,37,957,46,944,697,794,748,890,5
00018814_000.png,80,938,38,773,608,708,670,801,5
00025707_015.png,14,960,124,982,697,789,665,870,5
00012045_019.png,143,902,52,746,280,335,283,390,5
00002290_001.png,37,931,25,976,223,286,261,333,5
00012592_005.png,95,945,48,705,676,762,714,828,5
00027937_004.png,23,911,70,941,143,252,182,353,5
00013674_000.png,0,971,89,1024,210,268,179,325,5
00013751_003.png,54,922,54,886,622,711,657,800,5
00010103_014.png,124,996,44,930,219,260,216,305,5
00011576_000.png,62,956,76,874,144,190,114,231,5
00030413_003.png,97,961,38,966,158,246,208,322,5
00011136_002.png,66,900,73,925,508,737,664,903,6
00022290_015.png,135,995,64,919,68,312,248,845,6
00017710_009.png,8,860,38,969,112,365,327,961,6
00003894_005.png,32,912,40,888,549,839,799,1278,6
00021670_004.png,99,911,61,884,508,748,687,909,6
00011514_015.png,61,920,64,814,491,687,623,863,6
00013625_069.png,34,941,127,973,91,820,693,1442,6
00005869_001.png,41,957,9,688,134,312,303,591,6
00005869_001.png,41,957,9,688,139,384,375,464,7
00000193_019.png,24,968,6,986,679,897,891,1146,6
00016732_027.png,69,948,34,847,548,767,733,961,6
00012045_005.png,79,925,36,801,512,756,720,1027,6
00000506_013.png,117,940,38,882,449,709,671,1291,6
00003064_035.png,0,883,71,977,538,817,746,1074,6
00018032_000.png,133,980,108,998,117,261,153,372,6
00005532_022.png,0,846,46,903,548,722,676,912,6
00023283_005.png,83,916,79,867,465,683,604,908,6
00008291_011.png,48,922,32,906,136,850,818,1441,6
00022084_000.png,48,969,3,943,161,924,921,1392,6
00016291_020.png,0,867,38,970,533,773,735,1040,6
00002980_000.png,145,977,125,1024,118,703,578,999,6
00011237_006.png,89,926,24,885,115,319,295,658,6
00010828_023.png,0,899,74,826,575,838,764,1186,6
00007728_013.png,37,906,28,962,92,325,297,635,6
00012576_004.png,112,923,63,882,83,353,290,631,6
00017952_008.png,0,959,56,983,198,418,362,858,6
00021489_013.png,0,901,56,716,526,779,723,1006,6
00014956_010.png,93,961,42,947,506,866,824,1454,6
00008291_009.png,0,855,53,903,75,796,743,1455,6
00022961_008.png,0,925,16,836,564,777,761,921,6
00021772_011.png,33,899,72,843,65,812,740,1393,6
00003789_000.png,102,934,0,870,170,270,270,363,6
00014125_042.png,0,915,34,798,253,809,775,1243,6
00014839_017.png,96,918,1,814,516,720,719,1014,6
00011583_000.png,18,950,69,867,599,854,785,1058,6
00021303_005.png,21,960,35,918,202,418,383,656,6
00022178_000.png,32,1008,0,1010,200,348,348,501,6
00003528_024.png,106,917,51,953,538,723,672,1077,6
00007629_001.png,6,938,29,909,625,799,770,977,6
00010610_003.png,35,927,48,1024,165,350,302,640,6
00019863_010.png,43,935,46,821,123,364,318,554,6
00014294_011.png,51,954,68,862,649,827,759,989,6
00012094_011.png,70,943,13,892,143,344,331,721,6
00005567_025.png,19,975,58,898,589,737,679,927,6
00000150_002.png,115,893,40,911,486,701,661,881,6
00013992_005.png,30,959,41,938,202,373,332,659,6
00015605_051.png,45,954,69,949,166,313,244,475,6
00005353_000.png,30,923,0,970,83,310,310,691,6
00026848_007.png,43,924,85,1024,158,348,263,523,6
00004893_070.png,85,899,42,863,115,275,233,428,6
00022021_002.png,113,905,53,811,154,308,255,401,6
00007735_018.png,43,943,47,933,541,750,703,1045,6
00011831_008.png,131,973,76,844,107,251,175,483,6
00016291_012.png,20,954,81,1013,126,328,247,563,6
00019765_010.png,39,936,47,1024,156,367,320,499,6
00023138_009.png,89,936,0,962,81,341,341,851,6
00013272_005.png,6,938,92,1024,605,824,732,1131,6
00004344_002.png,106,927,55,893,148,319,264,711,6
00014197_010.png,46,973,72,1014,574,906,834,1101,6
00027837_001.png,29,938,44,953,180,395,351,771,6
00010652_000.png,90,914,60,840,114,326,266,431,6
00009863_058.png,0,965,26,790,314,496,470,758,6
00020845_002.png,61,923,67,861,112,330,263,512,6
00019157_008.png,65,927,25,922,526,813,788,1296,6
00009229_003.png,130,970,31,922,74,272,241,424,6
00007444_003.png,38,998,45,844,588,817,772,1058,6
00001933_000.png,0,928,0,951,554,729,729,922,6
00002711_000.png,34,936,0,952,153,427,427,801,6
00009107_006.png,16,949,22,891,159,397,375,802,6
00027758_004.png,126,939,83,825,97,336,253,459,6
00023089_004.png,0,878,69,859,158,327,258,451,6
00021860_003.png,37,933,65,925,99,329,264,504,6
00013993_013.png,34,952,48,926,555,739,691,974,6
00010447_018.png,61,923,33,971,99,331,298,559,6
00008727_009.png,84,945,104,1024,121,358,254,573,6
00017236_075.png,0,893,0,955,40,348,348,714,6
00023178_002.png,133,882,44,875,428,658,614,1095,6
00021818_026.png,73,941,56,809,527,791,735,1088,6
00016064_010.png,127,993,0,918,100,347,347,555,6
00005567_000.png,6,882,64,933,560,803,739,1055,6
00014177_009.png,31,975,4,976,666,908,904,1364,6
00004808_090.png,17,953,42,864,118,407,365,770,6
00014022_054.png,79,895,103,1024,538,715,612,968,6
00012834_113.png,84,944,96,979,484,750,654,1173,6
00022572_073.png,0,921,90,853,553,865,775,1281,6
00003391_001.png,151,1010,45,961,159,380,335,740,6
00009507_004.png,131,1010,122,954,81,341,219,510,6
00029469_009.png,0,869,47,999,469,843,796,1216,6
00019892_003.png,0,973,40,878,570,824,784,922,7
00026586_009.png,13,970,112,973,183,353,241,482,7
00003400_003.png,38,945,0,840,570,811,811,1039,7
00010767_016.png,57,900,64,944,60,371,307,962,7
00017972_026.png,11,961,0,950,652,743,743,947,7
00018865_008.png,68,949,39,836,141,285,246,377,7
00029909_003.png,41,958,52,933,126,359,307,448,7
00029579_014.png,14,844,54,878,87,123,69,247,7
00020318_007.png,35,949,14,701,680,900,886,1016,7
00013807_009.png,58,920,43,994,257,378,335,421,7
00010767_007.png,0,841,8,852,264,348,340,369,7
00009368_006.png,85,917,77,1017,283,351,274,457,7
00021748_000.png,108,897,19,875,442,609,590,663,7
00010767_008.png,31,835,59,843,172,336,277,478,7
00014083_023.png,94,924,55,865,546,823,768,956,7
00023078_003.png,24,939,82,864,71,201,119,313,7
00010071_008.png,150,970,81,1024,53,124,43,306,7
00013471_002.png,53,961,53,939,76,346,293,444,7
00012094_040.png,111,915,37,832,466,611,574,716,7
00010936_016.png,53,889,75,943,121,353,278,490,7
00025252_054.png,0,873,37,981,659,803,766,1028,7
00019124_104.png,29,937,38,830,89,382,344,721,7
00027213_044.png,50,952,57,976,520,729,672,1541,7
00017137_016.png,110,892,54,927,60,347,293,822,7
00014822_039.png,147,971,53,889,497,691,638,1314,7
00023162_025.png,111,906,0,870,81,344,344,601,7
00026451_068.png,127,915,42,971,168,290,248,385,7
00013209_018.png,80,936,33,929,110,395,362,629,7
00013310_059.png,96,929,37,874,97,283,246,849,7
00025787_050.png,54,930,8,1004,557,611,603,862,7
00009889_018.png,61,918,22,915,63,97,75,136,7
00022141_030.png,151,987,19,957,392,495,476,554,7
00020146_005.png,121,911,0,898,60,356,356,586,7
00016429_015.png,95,1024,26,839,52,432,406,1000,7
00026392_005.png,0,973,27,970,563,879,852,1135,7
00022141_023.png,169,1024,87,1001,475,687,600,816,7
00017747_008.png,102,1024,74,860,127,328,254,486,7
00018496_007.png,0,950,74,1005,572,795,721,889,7
00005140_001.png,52,952,67,940,73,212,145,658,7
00001248_038.png,90,914,30,884,477,730,700,897,7
00018055_005.png,21,984,84,1024,113,455,371,925,7
00008841_044.png,52,925,0,900,95,418,418,583,7
00028876_027.png,94,910,45,938,443,674,629,817,7
00002176_007.png,92,938,90,812,166,273,183,388,7
00029259_027.png,117,913,47,909,670,782,735,1073,7
00025368_018.png,43,959,65,805,108,426,361,697,7
00027278_007.png,73,933,0,951,80,390,390,667,7
00011831_010.png,119,956,55,852,116,356,301,528,7
00002176_005.png,122,929,72,780,138,325,253,481,7
00029807_003.png,108,945,19,974,56,412,393,714,7
00009166_004.png,76,874,43,1019,80,163,120,465,7
00025368_033.png,41,975,10,818,718,916,906,1109,7
00020408_058.png,91,922,21,917,70,358,337,751,7
00025954_025.png,144,965,41,902,53,327,286,577,7
00021782_028.png,44,920,38,830,89,311,273,753,7
00016568_026.png,77,899,43,948,22,276,233,865,7
00029075_013.png,114,914,45,899,542,792,747,1021,7
00012622_016.png,122,950,21,895,641,722,701,848,7
00004342_050.png,149,1006,86,1017,36,172,86,594,7
00028861_009.png,72,918,29,951,509,800,771,1100,7
00021700_010.png,61,933,40,815,526,727,687,892,7
00020318_022.png,37,937,45,917,514,790,745,1029,7
00007471_003.png,0,913,57,702,540,873,816,1356,7
00028628_008.png,55,899,39,885,551,762,723,1084,7
00011355_011.png,0,991,34,931,500,928,894,1382,7
00030606_006.png,40,910,11,911,510,746,735,907,7
00027652_003.png,0,875,63,881,75,220,157,734,7
00021896_003.png,145,983,32,953,93,319,287,533,7
00011355_027.png,3,965,103,1010,557,877,774,1150,7
00028924_009.png,29,926,56,942,701,825,769,1085,7
00025787_039.png,17,929,19,927,69,252,233,821,7
00018055_038.png,0,971,40,1024,125,213,173,424,7
00016937_014.png,27,925,54,900,145,410,356,616,7
00019706_002.png,14,909,29,922,562,714,685,833,7
00020671_010.png,137,1009,32,892,82,274,242,489,7
00014626_017.png,142,903,63,899,129,230,167,380,7
00019124_006.png,0,954,18,867,527,872,854,1167,7
00018055_045.png,0,898,15,1024,89,133,118,231,7
00019917_004.png,48,928,16,946,565,813,797,859,0
00001153_004.png,69,929,35,853,238,335,300,774,0
00012299_002.png,99,918,60,894,96,754,694,833,0
00029464_003.png,2,1008,48,741,241,445,397,573,0
00001320_003.png,136,886,72,777,72,144,72,173,0
00013187_002.png,119,940,50,907,79,817,767,992,0
00025769_001.png,49,908,41,941,652,755,714,818,0
00026920_000.png,47,926,27,895,296,416,389,469,0
